A Dong : Adam
A La Hán : Arhant, Lohan (follower of Buddha)
A Lịch Sơn : Alexander
A Lịch Sơn Đắc Lộ : Alexandre de Rhodes
A Phú Hãn : Afghanistan; Afghanistani, Afghan
A di đà phật : Amnida Buddha; thank heavens!
A đam : Adam
A, tội nghiệp quá : Oh!, What a pity!
Ai Cập : Egypt, Egyptian
Ai Cập học : Egyptology
Ai Lao : Laos, Laotian
Ai khiến anh! : Nobody asked you to do that!
An Nam : Annam, Annamese, Annamite
An ba ni : Albania
Anh Cát Lợi : England
Anh Mỹ : Anglo-American
Anh Quốc : England
Anh kim : British pound, pound sterling
Anh lý : English mile
Anh ngữ : English language
Anh ngữ kém : poor English
Ba Lan : Poland
Ba Lê : Paris
Ba Nhĩ Cán : (the) Balkans
Ba Tây : Brazil, Brazilian
Ba Tư : Persia, Persian, Iran, Iranian
Ba Tỉ Luân : Babylon
Bao Tích Nhược : (character in the book “Anh Hùng Xà Điêu”)
Binh thư yếu lược : The Art of War (book by Sun Tzu)
Biết làm thế nào bây giờ : What can one do now!
Biển Băng : Mare Frigoris (lunar sea)
Biển Cả Bảo Tố : Oceanus Procellarum
Biển Hài Hước : Mare Humorum (lunar sea)
Biển Hơi : Mare Vaporum (lunar sea)
Biển Khủng Hoảng : Mare Crisium (lunar sea)
Biển Mây : Mare Nubium (lunar sea)
Biển Mưa Gió : Mare Imbrium (lunar sea)
Biển Nam Hải : South Sea
Biển Phong Phú : Mare Foecondatus
Biển Thái Bình Dương : the Pacific Ocean
Biển Trong : Mare Seranitatis
Biển Trầm Lặng : Mare Traquilitatis
Biển Ðông : South China Sea
Biển Đông : South China Sea
Biển Địa Trung Hải : Mediterranean Sea
Brazin : Brazil
Bà La Môn : Brahman
Bàu Sỏi : (name of a village)
Bá Linh : Berlin
Bái hỏa giáo : Zoroastrianism
Bát Quái Đài : octagonal palace (Cao Dai)
Bình Nhưỡng : Pyongyang
Bình Định : (province name)
Băng Cốc : Bangkok
Băng Ðảo : Iceland
Bạch Cung : the White House
Bạch Mi : God of Prostitutes
Bạch Nga : White Russian, Byelorussian
Bạch tuyết : Snow White
Bạch Ốc : the White House
Bản Châu : Honshu (region of Japan)
Bản Môn Điếm : Panmunjon
Bảo Gia Lợi : Bulgaria, Bulgarian
Bảo quốc Huân chương : National Order Medal
Bấc Âu : Northern Europe, Scandinavia
Bắc Bang Dương : Arctic Ocean
Bắc Bình : Peiping
Bắc Bộ : north(ern) region of Vietnam
Bắc Cali : Northern California
Bắc Cao : North Korea
Bắc Cao Ly : North Korea
Bắc Cực : North Pole
Bắc Hà : North Vietnam
Bắc Hàn : North Korea
Bắc Hải Đạo : Hokkaido (region of Japan)
Bắc Kinh : Peking, Beijing
Bắc Kỳ : North Vietnam
Bắc Mỹ : North America, North American
Bắc Phi : North Africa
Bắc Phần : Northern part (of Vietnam)
Bắc Triều Tiên : North Korea
Bắc Việt : North(ern) Vietnam
Bắc Âu : Northern Europe, Scandinavia
Bắc Ðẩu Bội Tinh : (French) Legion of Honor medal
Bắc Đại Tây Dương : North Atlantic (Ocean)
Bắc Đầu : Ursa Major (constellation)
Bệ Hạ : Sire, Your Majesty
Bỉ Lợi Thì : Belgium, Belgian
Bỉ quốc : Belgium
Bồ Tát : Bodhisattva
Bồ Đào Nha : Portugal, Portuguese
Bộ Canh Bịnh : Ministry of Agriculture
Bộ Canh Nông : Ministry of Agriculture
Bộ Công Chánh : Ministry of Public Works
Bộ Công nghiệp : Ministry of Industry
Bộ Cựu Chiên Binh : Office of Veteran Affairs
Bộ Giao Thông Vận Tải : Department of Transportation
Bộ Giáo Dục : Ministry of Education
Bộ Kinh Doanh : department of commerce
Bộ Kinh Tế : department of the economy (or economic affairs)
Bộ Kế Hoạch : Ministry of Planning
Bộ Lao động : Ministry of Labor
Bộ Mậu Dịch : Ministry of Trade
Bộ Ngoại Giao : Foreign Ministry
Bộ Ngoại Thương : Ministry of Foreign Trade
Bộ Ngoại Thương và Kỹ Nghệ : the Ministry of International Trade and Industry (MITI)
Bộ Nông Nghiệp : Ministry of Agriculture
Bộ Nội Vụ : Ministry of Domestic Affairs
Bộ Quốc Phòng : Department of Defense
Bộ Quốc gia Giáo dục : Ministry of National Education
Bộ Thông Tin : Ministry of Information
Bộ Trưởng Bộ Ngoại Giao : Foreign minister, Secretary of State
Bộ Trưởng Giáo Dục : Minister of Education
Bộ Trưởng Ngoại Giao : Foreign Secretary
Bộ Trưởng Ngoại Vụ : Minister of Foreign Affairs
Bộ Trưởng Năng Lượng : Department of Energy
Bộ Trưởng Quốc Phòng : Secretary, Ministry of Defense
Bộ Trưởng Thương Mại : Secretary of Trade, Commerce
Bộ Trưởng Tư Pháp : justice minister
Bộ Tài Chánh : Ministry of Finance
Bộ Tài Chính : Ministry of Finance
Bộ Tư Pháp : Ministry of Justice; Justice Department
Bộ Văn Hóa Giáo Dục và Thanh Niên : Ministry of Education and Youth
Bộ Xã Hội : Ministry of Social Welfare
Bộ Y Tế : Ministry of Public Health
Bộ Đại Đông Á : the Greater East Asia Ministry
Bụt : Buddha
Bức Màn Sắt : Iron Curtain
CNT : Cộng Hòa Nhân Dân Trung Hoa (People’s Republic of China)
CS : cộng sản (communist)
CSVN : Cộng Sản Việt Nam (Communist Vietnam)
CT : chủ tịch (chairman, president)
CXCV : Cộng hòa Xã hội chủ nghĩa Việt Nam (the Socialist Republic of Vietnam)
Cali : California
Cam Bốt : Cambodia
Cam Túc : Kansu
Cam Địa : (Mahatma) Ghandi
Cao Ly : Korea
Cao Miên : Cambodia, Cambodian
Cao Mên : Cambodia, Cambodian
Cao Đài : Cao Dai (a Vietnamese religion)
Cao Đài Giáo : Cao Dai (Vietnamese religion)
Cha Bề Trên : Father Superior
Cha bề trên : Father superior
Cha, mắc quá : Oh, that’s too expensive!
Chiêm Thành : Champa
Châu Á : Asia, Asian continent
Châu Âu : Europe, European Continent
Châu Đốc : Chaudoc
Chùm nho chín mọng : A bunch of ripe and succulent grapes
Chúa cứu thế : the Savior
Chưởng Pháp : censor cardinal (Cao Dai)
Chưởng Ấn : chancellor (Cao Dai)
Chả có gì sốt : There is nothing at all
Chắc anh ấy sắp đến : He’ll probably be here soon
Chức Việc : subdignitaries (Cao Dai)
Chữ Thập Đỏ : the Red Cross
Con người chỉ mưu cầu danh lợi : A person who only seeks honors and privileges
Cracốp : Krakow
Cách mạng Hoa Kỳ : American Revolution
Còn ông thì sao? : How about you?
Có mốc xì gì đâu! : Nothing at all like that!
Cô Liên đến chưa? : Has Miss Lien arrived yet?
Côn Sơn : Con-Son (island)
Căm Bốt : Cambodia
CĐVN : Cộng Đồng Việt Nam
Cơ Quan Viện Trợ Mỹ : USOM
Cơ Quan Điều Tra Liên Bang Hoa Kỳ : Federal Bureau of Investigation, FBI
Cơ quan nguyên tử năng quốc tế : International Atomic Energy Agency, IAEA
Cơ quan năng lượng quốc tế : International Energy Agency, IEA
Cơ Đốc : Christ, Christian, Christianity
Cơ Đốc giáo : Christianity
Cạn bôi! : Bottom’s up!
Cải Trạng : lawyer (Cao Dai)
Cận Động : Near East
Cộng Hòa Liên Bang Nga : Russian (Federated) Republic
Cộng Hòa Xã Hội Chủ Nghĩa Việt Nam : the Socialist Republic of Vietnam
Cộng Sản Việt Nam : Communist Vietnam
Cộng Đồng (Chung) Âu Châu : European Community
Cộng Đồng Kinh Tế Âu Châu : European Economic Community, EEC
Cờ Vàng : Yellow Flag (rebels)
Cờ Đen : Black Flag (rebels)
Cục Bưu Điện : Post, Telephone, and Telegraph Office (PTT)
Cục Dự trữ Liên bang : Federal Reserve
Cục Quản Trị Lương Thực và Dược Phẩm : Food and Drug Administration, FDA
Cục Điều tiết điện lực : Electricity Regulatory Authority of Vietnam (ERAV)
Cứ từ từ : Take it easy
Cửu Châu : Kyushu (region of Japan)
Cửu Long : (river in Vietnam)
Cửu Trùng Đài : Nine Sphere Palace (Cao Dai)
Cựu Kim Sơn : San Francisco
Cựu Ước : Old Testament
Danh Dự Bội Tinh : Medal of Honor
Do Thái : Israel
Do Thái giáo : Judaism
Du Xom : USOM
Dòng Chúa Cứu Thế : the Redemptorists
Dạo này ông có phát tài không? : How’s business these days?
Dải Ngân hà : the Milky Way
GM : giám quản
GTGT : giá trị gia tăng (value added tax, VAT)
Geneve : Geneva
Gia Nã Đại : Canada
Gioan : John
Giám Đạo : General Inspector (Cao Dai)
Giáo Hội Công Giáo : Catholic Church
Giáo Tông : pope (Cao Dai)
Giê Su : Jesus
GĐ : giám đốc (director)
Hi Lạp : Greece, Greek
Hiếu kinh : the Classic of Filial Piety
Hiệp Chủng Quốc : United States
Hiệp Hội Súng Quốc Gia : National Rifle Association, NRA
Hiệp Thiên Đài : Heavenly Palace (Cao Dai)
Hiệp định không phổ biến vũ khí hạch nhân : Nuclear non-proliferation treaty
Hoa : (1) China; (2) flower, blossom
Hoa Kỳ : United States, America
Hoa Ngữ : Chinese (language)
Hoa Thịnh Đốn : Washington
Hoa Việt : Sino-Vietnamese
Hoàn Cầu Thời Báo : Global Times (a Chinese daily newspaper)
Huynh đệ Hồi giáo : Muslim brotherhood
Huê Kỳ : United States of America; American
Huê kỳ : America, United States
Huế : Hue (city in Vietnam)
Hy Lạp : Greece, Greek
Hà Lan : Holland, the Netherlands; Dutch
Hà Nội : Hanoi
Hàn Quốc : Korea
Hán : Chinese
Hán Thành : Seoul
Hán Việt : Sino-Vietnamese
Hán tụ : Chinese character, Hanzi
Hítle : Hitler
Hòa Lan : Holland, the Netherlands; Dutch
Hòa học : Japanese studies
Hòa văn : Japanese language or literature
HĐQT : hội đồng quản trị
Hương Cảng : Hong Kong
Hạ Uy Di : Hawaii
Hạ Viện : House of Representatives
Hạ uy cầm : Hawaiian guitar
Hải Nam : Hainan Island
Hải Phòng : Haiphong
Hải Sâm Uy : Vladivostok
Hải sư : Leo, the Lion
Hải vương tinh : Neptune
Hậu Lê : (Vietnamese dynasty)
Hệ số sự cố chạm đất : ground fault coefficient
Hỏa Tinh : Mars
Hồi : Islam, Islamic
Hồi Giáo : Islam
Hồi Giáo ôn hòa : moderate Islam
Hồi Quốc : Pakistan
Hồi Ấn : Indo-Pakistani
Hồng Bàng : (early clan in Vietnamese history)
Hồng Công : Hong Kong
Hồng Kông : Hong Kong
Hồng Thập Tự : Red Cross
Hộ Pháp : legislative affairs director (Cao Dai)
Hộ Pháp Cao Đài : Cao Dai pope
Hội Hồng Thập Tự : Red Cross
Hội Nghị đại đông Á : the Greater East Asia Conference
Hội Quốc Liên : the League of Nations
Hội Y Sĩ Hoa Kỳ : American Medical Association
Hội phụ huynh học sinh : Parent-Teacher Association, PTA
Hội Ân Xá Quốc Tế : Amnesty International
Hội Đồng Bảo An : security council
Hội đồng Quý Tộc : House of Peers
I Rắc : Iraq
KH&KT : Khoa Học và Kỹ Thuật
KHCN : khoa học công nghẹ
KHĐT : science and technology
Kha Luân Bố : Christopher Columbus
Khoa Học và Kỹ Thuật : Science and Technology
Khoan đã! : Hold on (a second)!
Không Quân Việt Nam : Vietnamese air force
Không ai hỏi chúng tôi hết : No one asked us
Không ai đến dốt cả : No one came at all
Không có sự sống trên Trăng : there is no life on the moon
Khơ Me Đỏ : Khmer Rouge
Khối Cộng Đồng Chung Âu châu : European Union
Khối Phòng Vệ Bắc Đại Tây Dương : North Atlantic Treaty Organization, NATO
Khối Thịnh Vượng Chung Đại Đông Á : The Greater East Asia Coprosperity Sphere
Khối Trục : the Axis Alliance
Khối Ả Rập : Arab block
Khổ chưa! : How unfortunate!
Khổng : Confucius, Confucian
Khổng Minh : Zhuge Liang
Khổng Minh Gia Cát Lượng : Zhuge Liang
Khổng Tử : Confucius
Khổng giáo : Confucianism
Ki Ri Xi Tô : Christ
Ki Tô : Christ
Ki Tô Giáo : Christianity
Kim Tinh : Venus
Kinh Thánh : the Bible
Kitô hữu : (a) Christian
Kremli : Kremlin
LHQ : Liên Hiệp Quốc
LTS : lời tòa soạn
La Hán : Arhat
La Mã : Rome, Roman
La Phương : Lafayette
La Sát : Goddess of Anger
La Tinh : Latin, Roman
La Tinh hóa : to Romanize, Romanization
Lai Châu : (province name)
Liên Bang Nga : the Russian Union, Federation
Liên Bang Nga là một vang bóng của Liên Xô ngày xưa : The Russian Federation is only a shadow of the former Soviet Union
Liên Bang Sô Viết : Soviet Union
Liên Bang Xô Viết : Soviet Union
Liên Hiệp Anh : British Commonwealth
Liên Hiệp Châu Phi : African Union
Liên Hiệp Quốc : United Nations
Liên Hiệp Âu Châu : European Union
Liên Mạng Toàn Cầu : World Wide Web
Liên bang Nga : Russian Federation
Liên đoàn Ả Rập : the Arab League
Long Biên : the ancient name of Hanoi
Long Vương : River God
Luân Đôn : London
Luật Điện lực : Electrical Power Regulation
Làm chỗ ấy bở lắm : One earns a lot of extra money in that position
Lào : Laos
Lâu rồi không gặp anh : I haven’t seen you in a long time
Lê Nin : Lenin
Lõm Giũa : Sinus Medii
Lõm Sương : Sinus Roris
Lý Thừa Vãn : Syngman Rhee
Lý Tiểu Long : Bruce Lee
Lưu Cầu : Ryuukyu
Lưu ý là : (Please) note that ~
Lạc Vịet : old name for Vietnam
Lại nhà hàng Thanh Thế đi ! : How about going to the Thanh The (restaurant)?
Lạt Ma Giáo : Tibetan Buddhism
Lấy gì làm bằng? : What can we use as evidence?
Lễ Phục Sinh : Easter
Lễ Tạ Ơn : Thanksgiving (American holiday)
Lời chào cao hơn mâm cỗ : A polite greeting is better than a good meal
Lục Tỉnh : the Delta
Lục Xuâm Bảo : Luxembourg
Lữ Y : Louis
Lực Lượng Tự Vệ : (Japanese) Self-Defense Forces
Lực lượng Tuần duyên : Coast Guard
MK : Mỹ Kim
Ma Cao : Macao or stroke lightly, graze
Ma Ní : Manila
Mao Trạch Đông : Mao Tse Tung
Matxcova : Moscow
Minh Trị : Meiji (Emperor of Japan)
Minh Trị Phục Hưng : Meiji Restoration
Miên : (1) Cambodia, Cambodian; (2) to sleep; (3) cotton; (4) to be long
Miên hoàng : King of Cambodia
Miên Đất Hứa : the Promised Land
Miến : Burma (short for Miến Điện)
Miến Điện : Burma
Miền Trung : Central Vietnam
Miền Trung đông : Middle East region
Mác Lê : Marxist-Leninist
Mác Lê Nin : Marxist-Leninist
Máy này chạy bằng dầu tây : That motor uses kerosene
Mã Lai : Malay
Mã Lai Á : Malaysia
Mãn Châu : Manchuria
Mông Cổ : Mongolia
Mũi Hảo Vọng : Cape of Good Hope
Mạc Tư Khoa : Moscow
Mạnh Tử : Mencius
Mễ Tây Cơ : Mexico
Mồng hai : The second
Mộ Chiến Sĩ Vô Danh : the Tomb of the Unknown Solider
Mộc : Jupiter
Mỹ : America, USA, American
Mỹ Kim : US dollar
Mỹ châu : America
Mỹ nâu : brown American, Hispanic-American, Latino-American
Mỹ trắng : white American
Mỹ vàng : yellow American, Asian-American
Mỹ đen : black American, African-American
Mỹ đỏ : red American, Native American, American Indian
Mỹ-Việt : U.S.-Vietnam
NN : Nhân Hàng Nhà Nước (National Bank of VN)
Na Uy : Norway
Nam Cali : Southern California
Nam Cực : South Pole
Nam Dương : Indonesia
Nam Hàn : South Korea
Nam Kỳ : Cochichina
Nam Mỹ : South America
Nam Phi : South Africa
Nam Triều Tiên : South Korea
Nam Tư : Yugoslavia
Nam Vang : Phenom Penh
Nga : Russia(n)
Nga Sô : Soviet Russia
Ngáp gì? : What are you yawning for?
Ngân Hàng Nhà Nước : National Bank (of VN)
Ngân Hàng Nông Nghiệp : Vietnam Bank For Agriculture
Ngân Hàng Thương Mại : Vietcombank
Ngân Hàng Thương Mại Cổ Phần Sài Gòn : Saigon Commercial Bank
Ngân Hàng Thương Mại Quốc Tế : Incombank
Ngân Hàng Thế Giới : World Bank
Ngân Hàng Trung Ương : Central Bank
Ngân Hàng Đầu Tư và Phát Triển : Bank for Investment and Development
Ngân hàng TMCP dầu khí toàn cầu : Global Petroleum Commercial Bank
Ngô : (Vietnamese dynasty)
Ngô Đình Diệm : (first president of South Vietnam)
Ngôi đền Vàng Kinkaku-gi : the Golden Temple
Ngũ Giác Đài : (the) Pentagon
Ngọc tuyền : Hades
Nha An Ninh Xã Hội Bắt Đầu : Social Security Office
Nho Giáo : Confucianism
Nho gia : Confucian scholar
Nho giả : Confucian scholar
Nho học : Confucianism
Nho lâm : Confucian scholars (collective)
Nho phong : scholarly tradition
Nho sinh : student of Confucianism
Nho sĩ : (Confucian) scholar
Nho đạo : Confucianism
Nhã Ðiển : Athens
Nhật : Japan, Japanese
Nhật Bản : Japan, Japanese
Nhật Hoàng : Japanese emperor
Nhọc Hoàng : the Jade Emperor
Nhữ Y : Noah
Nhựt : Japan
Nó bị bắt rồi : He was arrested
Nó bị kết án ba năm tù : He was sentenced to prison for three years
Nó không sốt : He doesn’t have a temperature
Nó ác lắm : He is very wicked
Nô Ê : Noah
Nôm : Nom (old Vietnamese writing system based on Chinese characters)
NĐ-CP : Nghị Định Chính Phủ
Nơi đây an nghĩ : Here lies ~ (on a gravestone)
Nội Bài : (airport in Hanoi)
Nội Mông : Inner Mongolia
Nữu Ước : New York
P.GĐ : phó giám đốc
PP : phó phòng
Pete Peterson thuộc đảng Dân Chủ : Pete Peterson, (a) Democrat
Phao Lồi : Paul (Paulo)
Phi Châu : Africa, African continent
Phi Luật Tân : the Philippines; Filipino
Phái Bộ Viện Trợ Quân Sự : MAC-V (Military Assistance Command - Vietnam)
Pháp Luân Công : Falun Gong
Pháp ngữ : French (language)
Phù Tang : Japan (literary)
Phú Sĩ : Fuji
Phúc Kiến : Fukien
Phạn : (1) Buddhist; (2) cooked rice
Phạn học : Sanskrit studies, Buddhist studies
Phạn ngữ : Sanskrit, Pali
Phạn thư : book in Sanskrit
Phạn tự : Sanskrit
Phạn điển : Pali canons
Phần Lan : Finland
Phật : Buddha
Phật Giáo : Buddhism
Phật Giáo tiểu thừa : Hinayana (Theravada) Buddhism, lesser path Buddhism
Phật Giáo đại thừa : Mahayana Buddhism, greater path Buddhism
Phật Tử : Buddhist (person)
Phật học : (study of) Buddhism
Phật sự : Buddhist matters, affairs, activities
Phật Đản : the birthday of Buddha
Phối Sư : archbishop (Cao Dai)
Quan thoại : Mandarin Chinese (language)
Quan đông : Kanto (region of Japan)
Quyền Giáo Tông : acting pope
Quân Độ Hoa Kỳ : US Armed Forces
Quên thế nào được : How can I forget
Quảng trường Quốc gia : National Mall (in Washington DC)
Quảng Đông : Kwangtung
Quỹ Tiền Tệ Quốc Tế : International Monetary Fund, IMF
Roma : Rome
Sao vậy? : How come?, Why?, How so?
Sao ông đi lâu vậy? : How come you’ll be gone so long?
Sài Gòn : Saigon
Sô Viết : Soviet
Sô Viết hóa : to Sovietize
Sĩ Tải : archivist (Cao Dai)
Sấm Truyền Ca : Book of Prophesy (c. 1670)
Sở Hưu Bổng : Retirement Bureau
Sở Thuế Vụ : Tax Office
Sở Thông Tin Hoa Kỳ : USIS
Sứ Quán Anh : British Embassy
Sứ Quán Mỹ : American Embassy
Sứ Quán Việt Nam : Vietnamese Embassy
TCT : corporation
TGĐ : Tổng giám đốc
TL : tây lịch
TNHH : trách nhiệm hữu hạn
TP.HCM : (abbreviation for Thành Phố Hồ Chí Minh)
TPHCM : thành phố Hồ Chí Minh
TQ : Trung Quốc
TQLC : (thủy quân lục chiến) Marines
TT : thủ tướng, tổng thống
Tam Bảo : Buddhist trinity
Tang : (1) Tibet, Tibetan
Thai Dương : sun
Thai Dương Hệ : Solar system
Thanh Hóa : (province name)
Thiên An Môn : Tiananmen
Thiên Hoàng : Mikado
Thiên Hỉ Động : Palace of Wisdom (Cao Dai)
Thiên Tân : Tien Tsin
Thiên bình : Libra (constellation)
Thiên trúc : India
Thiên vương tinh : Uranus
Thiên xà : Serpentarius, Ophiuchus
Thiên xúng : Libra
Thiền học : Zen
Thành Hồ : Ho Chi Minh City (Saigon)
Thành Phố Hồ Chí Minh : Ho Chi Minh City (Saigon)
Thái : Thai	
Thái Bình Dương : the Pacific Ocean
Thái Cực Đạo : Tae Kwon Do
Thái Hòa Phục Hưng : Showa Restoration
Thái Lan : Thailand
Thái Sơn : (name of a mountain in China)
Thát Đát : Tartar, Mongol
Thông Tấn Xã Việt Nam : Vietnamese News Agency
Thư Viện Quốc Hội Hoa Kỳ : The Library of Congress
Thượng Cổ : Antiquity
Thượng Hải : Shanghai
Thượng Phẩm : religious affairs director (Cao Dai)
Thượng Sanh : secular affairs director (Cao Dai)
Thượng Đế : God, Allah, the Almighty
Thần đạo : Shinto
Thế Vận Hội : the (World) Olympic Games
Thế vận hội mùa Đông : (Olympic) Winter Games
Thổ Nhĩ Kỳ : Turkey, Turkish
Thụy Sĩ : Switzerland, Swiss
Thụy điển : Sweden
Thừa Sử : historian (Cao Dai)
Tiên Rồng : The Fairy and the Dragon (ancestors of the Vietnamese race)
Tiêu Chuẩn Kỹ Nghệ Nhật Bản : Japanese Industry Standard (JIS)
Tiếng Nói Hoa Kỳ : Voice of America
Tiếp Dẫn Đạo Nhơn : instructor (Cao Dai)
Tiểu Á : Asia Minor
Tiểu Á Tế Á : Asia minor
Tiệp Khắc : Czechoslovakia
Triều Tiên : Korea
Trung Cổ : the Middle Ages
Trung Cộng : Chinese Communists, Communist China
Trung Hoa : China, Chinese
Trung Hoa Cộng Sản : Communist China
Trung Hoa lục địa : mainland China
Trung Hoa đơn giản : simplified Chinese (characters)
Trung Mỹ : Central America
Trung Phi : Central Africa
Trung Quốc : China
Trung Quốc chung biên cương với 14 quóc gia : China shares a border with 14 countries
Trung Quốc thua Nhật Bản : China lost to Japan
Trung Việt Nam : Central Vietnam
Trung Á : Central Asia
Trung Âu : Central Europe
Trung Đông : middle east
Truyền Trạng : Investigator (Cao Dai)
Truyện Kiều : the Tale of Kieu (by Nguyễn Du)
Trân Châu Cảng : Pearl Harbor
Trình tự phục hồi phụ tải : load recovery procedure
Trí Huệ Cung : meditation hall (Cao Dai)
Trường Đỏ : Red Square (in Moscow)
Trạm Không Gian Quốc Tế : International Space Station
Trần : (Vietnamese dynasty)
Trận Thế Chiến Thứ Nhất : World War II, Second World War
Tàu ô : corsair
Táo quân : Kitchen God
Tân Gia Ba : Singapore
Tân Hoa Xã : Chinese press agency
Tân Sơn Nhất : Tan Son Nhat (airport)
Tân Tây Lan : New Zealand
Tân tổng thống : new president
Tân Đề Li : New Delphi
Tân Ước : New Testament
Tây : West, Western, Occidental, French
Tây Ban Nha : Spain, Spanish
Tây Bá Lợi á : Siberia
Tây Ninh : (province name)
Tây Sơn : (Vietnamese dynasty)
Tây Tạng : Tibet, Tibetan
Tây bán cầu : Western hemisphere
Tây hiệu : Western-brand (e.g. product)
Tây phương : the West, Occident
Tây Âu : Western Europe; the West, Occident
Tây Đức : West Germany
Tây Ấn : West Indies
Tòa Bạch Ốc : The White House
Tòa Kinh Tế : economic court
Tòa Thánh : Vatican; central building of a religion
Tòa Tối Cao Hoa Kỳ : U.S. Supreme Court
Tăng Đoàn Bảo Vệ Chánh Pháp : Buddhist Protection Society
Tương lai Cam Bốt còn nhiều bấp bênh : Cambodia’s future is still very unstable
Tướng Tưởng Giới Thạch : General Chang Kai Shek
Tấm Cám : Vietnamese version of the Cinderella story
Tết Nguyên Đán : Vietnamese New Year’s festival
Tối Cao Pháp Viện : Supreme Court
Tổ Chức An Ninh và Hợp Tác Âu Châu : Organization for Security and Cooperation in Europe (OSCE)
Tổ Chức Hiệp Ước Bắc Đại Tây Dương : North Atlantic Treaty Organization (NATO)
Tổ Chức Tiêu Chuẩn Quốc Tế : the International Standards Organization, ISO
Tổ Chức Y Tế Thế Giới : World Health Organization, WHO
Tổng Bí Thư đảng CSVN : General Secretary of the Communist Party
Tổng Giám Đốc Bưu Chính : Postmaster General
Tổng Thống Ba Lan đã làm bù nhìn chi Ngã : the Polish president became a puppet of Russia
Tổng thống Nga : Russian president
Tờ Quân Đội Nhân Dân : People’s Army (a newspaper)
Tứ Quốc : Shikoku (region of Japan)
Tứ Xuyên : Szechuan
Tự Đức : Vietnamese king (1840-1883)
VC : Việt Công
VN : Việt Nam
VNCH : Việt Nam Công Hoa
Vacxava : Warsaw
Vi Xi : VC, Viet Cong
Viện Bảo Hiến : Constitutional Court
Viện Sức Khỏe Quốc Gia : National Institute of Health
Việt : Vietnamese
Việt Cộng : Communist Vietnamese, Vietnamese Communists
Việt Hoa : Vietnamese - Chinese
Việt Minh : Vietminh
Việt Nam : Vietnam, Vietnamese
Việt Nam Cộng Hòa : Republican Vietnam, the Republic of Vietnam
Việt Nam Cộng Sản : Communist Vietnam
Việt Nam cũng như Nga : Vietnamese as well as Russian, Vietnamese and Russia alike
Việt Nam cận đại : contemporary, modern-day VN
Việt Nam hóa : Vietnamization; to translate into Vietnamese
Việt Nam kinh tế thời báo : Vietnam Economic Times
Việt Nam ngày xưa : former Vietnam, Vietnam of old
Việt cộng : Communist Vietnamese, Vietnamese Communists
Việt hóa : to Vietnamize, make or translate into Vietnamese
Việt hóa tên người : to transliterate someone’s name into Vietnamese
Việt học : Vietnamese studies
Việt kiều : Vietnamese resident, overseas Vietnamese
Việt ngữ : Vietnamese language
Việt-Anh : Vietnamese-English
Việt-Pháp : Vietnamese-French
Vân Nam : Yunnan
Vạn Tượng : Vientiane
Vậng ạ : Yes sir
Vệ Ðà : Veda
Vịnh Ba Tư : Persian Gulf
Vịnh Thái Lan : Gulf of Thailand
Vọng Các : Bangkok
Vụ trưởng Vụ Khoa học, Công nghệ : Director of the Department of Science and Industry
Xin ông cho biết ý kiến : Please give (us) your opinion
Xin ông cứ coi : Please take a look
Xiêm : Siam, Thailand
Xô Viết : Soviet
Yêrusalem : Jerusalem
Yêsu : Jesus
Yêsu Kitô : Jesus Christ